
Base de datos no relacional (mongoDB)
Colección principal: Siniestros

Esquema

{
  "_id": ObjectId, // Identificador único del siniestro (generado automáticamente por MongoDB)
  numeroSiniestro: numeroSiniestro,
  numeroPoliza: req.body.numeroPoliza,
  tipoDocumento: req.body.tipoDocumento,
  documento: req.body.documentoCliente,
  cliente: req.body.nombreCliente,
  direccionCliente: req.body.direccionCliente,
  telefonoCliente: req.body.telefonoCliente,
  mailCliente: req.body.mailCliente,
  tipoVehiculo: req.body.tipoVehiculo,
  patente: req.body.patente,
  marca: req.body.marca,
  modelo: req.body.modelo,
  anioFabricacion: req.body.anioFabricacion,
  numeroDeMotor: req.body.numeroDeMotor,
  numeroDeChasis: req.body.numeroDeChasis,
  tipoSiniestro: req.body.tipoSiniestro,
  fechaHoraSiniestro: req.body.fechaHoraSiniestro,
  descripcionSiniestro: req.body.descripcionSiniestro,
}


Ver boton editar en paginas de consultas






// Obtenemos la fecha del siniestro del cuerpo de la solicitud
  const fechaSiniestro = new Date(req.body.fechaSiniestro);
  // Obtenemos la fecha actual
  const fechaActual = new Date();
   // Verificamos si la fecha del siniestro es mayor a la fecha actual
   if (fechaSiniestro > fechaActual) {
    // Si la fecha del siniestro es mayor a la fecha actual, enviamos un mensaje de error
    console.log("La fecha del siniestro no puede ser mayor a la fecha actual");
  }
  // Si la fecha del siniestro es válida, continuamos con el ingreso del siniestro


                             
                 
                         